0000000000000000
0333333333333330
0333663333333330
0336333333663330
0333333333633330
1333333333633334
2333333333333335
0336333333333330
0336333333333330
0333663333333330
0333333333333330
0000000000000000 