0000000000000000
0333333333333330
0333336333333330
0333336333333330
0333336333333330
1333333333333334
2333333333333335
0333336333333330
0333336333333330
0333336333333330
0333333333333330
0000000000000000
