0000000000000000
0333333333368630
0336333333366630
0336333333333330
0333336666333330
1333336886333334
2333336886333335
0333336666333330
0336333333333330
0336333333333660
0333333333333680
0000000000000000
