0000000000000000
0333333333333680
0333333333333660
0336333333333330
0336333333333330
1336333336663334
2336333336863335
0336333336663330
0336663333333330
0333333333333330
0333333333333330
0000000000000000
