0000000000000000
0333333336663330
0333333336663330
0333333366633330
0336633366633330
1336333333333334
2336333333333335
0333336663333330
0333336663333330
0333366633333660
0333366633333680
0000000000000000
