0000000600000000
0333330603333330
0333330603333330
0336330003333330
0336333333333330
1336633333333334
2336633333333335
0336333333333330
0336330003333330
0333330603333330
0333330603333330
0000000600000000 