0000000000000000
0333333333333330
0333333633333330
0339336333393330
0333363333333330
1333633333333334
2333333933333335
0333333336333330
0333333336333330
0339333336333930
0333333336333330
0000000000000000 