0000000000000000
0833333333333330
0333363333333330
0333363333333330
0336663363333330
1333333363333334
2333333363333335
0336663363333330
0333363333333330
0333363333333330
0833333333333330
0000000000000000
