0000000000000000
0333333333333330
0333333333333330
0333333333333330
0333333333393330
1333333333333334
2333333933333335
0333333933333330
0336666633333330
0333333333333330
0333333333333330
0000000000000000 