0000000000000000
0333333333333330
0333333333333330
0336663333333330
0333363333393330
1333363333333334
2333333333333335
0333333333333330
0333333300333330
0333333300333330
0333333300333330
00000000000000000