0000000000000000
0333333333333330
0333333333333330
0336633333333330
0333633666333330
1333633686333334
2333633686333335
0333633666333330
0336633333333330
0333333333333330
0333333333333330
0000000000000000
