0000000000000000
0333333333333330
0333333333333330
0333333333363330
0333333333363330
1333333333363334
2333333333333335
0333333333333330
0333666633333330
0333333333333330
0333333333333330
00000000000000000